AF	afghanistan	Afghanistan
AL	albania	Albania
DZ	algeria	Algeria
AS	american-samoa	American Samoa
AD	andorra	Andorra
AO	angola	Angola
AI	anguilla	Anguilla
AG	antigua-and-barbuda	Antigua and Barbuda
AR	argentina	Argentina
AM	armenia	Armenia
AW	aruba	Aruba
AU	australia	Australia
AT	austria	Austria
AZ	azerbaijan	Azerbaijan
BS	bahamas	Bahamas
BH	bahrain	Bahrain
BD	bangladesh	Bangladesh
BB	barbados	Barbados
BY	belarus	Belarus
BE	belgium	Belgium
BZ	belize	Belize
BJ	benin	Benin
bm	bermuda	Bermuda
BT	bhutan	Bhutan
BO	bolivia	Bolivia
BQ	bonaire-st-eustatius-saba	Bonaire/St Eustatius/Saba
BA	bosnia-and-herzegovina	Bosnia and Herzegovina
BW	botswana	Botswana
BR	brazil	Brazil
None	british-antarctic-territory	British Antarctic Territory
IO	british-indian-ocean-territory	British Indian Ocean Territory
VG	british-virgin-islands	British Virgin Islands
BN	brunei	Brunei
BG	bulgaria	Bulgaria
BF	burkina-faso	Burkina Faso
MM	burma	Burma
bi	burundi	Burundi
KH	cambodia	Cambodia
CM	cameroon	Cameroon
CA	canada	Canada
CV	cape-verde	Cape Verde
KY	cayman-islands	Cayman Islands
CF	central-african-republic	Central African Republic
td	chad	Chad
CL	chile	Chile
CN	china	China
CO	colombia	Colombia
KM	comoros	Comoros
CG	congo	Congo
CR	costa-rica	Costa Rica
CI	cote-d-ivoire	Cote d’Ivoire
HR	croatia	Croatia
CU	cuba	Cuba
CW	curacao	Curaçao
CY	cyprus	Cyprus
CZ	czech-republic	Czech Republic
CD	democratic-republic-of-congo	Democratic Republic of Congo
DK	denmark	Denmark
DJ	djibouti	Djibouti
DM	dominica	Dominica
DO	dominican-republic	Dominican Republic
EC	ecuador	Ecuador
EG	egypt	Egypt
sv	el-salvador	El Salvador
GQ	equatorial-guinea	Equatorial Guinea
ER	eritrea	Eritrea
EE	estonia	Estonia
ET	ethiopia	Ethiopia
fk	falkland-islands	Falkland Islands
FJ	fiji	Fiji
FI	finland	Finland
FR	france	France
GF	french-guiana	French Guiana
PF	french-polynesia	French Polynesia
GA	gabon	Gabon
GM	gambia	Gambia
GE	georgia	Georgia
DE	germany	Germany
GH	ghana	Ghana
GI	gibraltar	Gibraltar
GR	greece	Greece
GD	grenada	Grenada
GP	guadeloupe	Guadeloupe
GT	guatemala	Guatemala
gn	guinea	Guinea
GW	guinea-bissau	Guinea-Bissau
GY	guyana	Guyana
HT	haiti	Haiti
VA	holy-see	Holy See
HN	honduras	Honduras
HK	hong-kong	Hong Kong
HU	hungary	Hungary
IS	iceland	Iceland
IN	india	India
ID	indonesia	Indonesia
IR	iran	Iran
IQ	iraq	Iraq
IE	ireland	Ireland
IL	israel	Israel
IT	italy	Italy
JM	jamaica	Jamaica
JP	japan	Japan
JO	jordan	Jordan
KZ	kazakhstan	Kazakhstan
KE	kenya	Kenya
KI	kiribati	Kiribati
None	kosovo	Kosovo
KW	kuwait	Kuwait
kg	kyrgyzstan	Kyrgyzstan
LA	laos	Laos
LV	latvia	Latvia
LB	lebanon	Lebanon
LS	lesotho	Lesotho
LR	liberia	Liberia
LY	libya	Libya
LI	liechtenstein	Liechtenstein
LT	lithuania	Lithuania
LU	luxembourg	Luxembourg
MO	macao	Macao
MK	macedonia	Macedonia
MG	madagascar	Madagascar
MW	malawi	Malawi
MY	malaysia	Malaysia
MV	maldives	Maldives
ML	mali	Mali
MT	malta	Malta
MH	marshall-islands	Marshall Islands
MQ	martinique	Martinique
mr	mauritania	Mauritania
MU	mauritius	Mauritius
YT	mayotte	Mayotte
MX	mexico	Mexico
FM	micronesia	Micronesia
MD	moldova	Moldova
MC	monaco	Monaco
MN	mongolia	Mongolia
ME	montenegro	Montenegro
MS	montserrat	Montserrat
MA	morocco	Morocco
MZ	mozambique	Mozambique
NA	namibia	Namibia
NR	nauru	Nauru
NP	nepal	Nepal
NL	netherlands	Netherlands
NC	new-caledonia	New Caledonia
NZ	new-zealand	New Zealand
NI	nicaragua	Nicaragua
NE	niger	Niger
NG	nigeria	Nigeria
KP	north-korea	North Korea
NO	norway	Norway
OM	oman	Oman
PK	pakistan	Pakistan
PW	palau	Palau
PA	panama	Panama
PG	papua-new-guinea	Papua New Guinea
PY	paraguay	Paraguay
PE	peru	Peru
PH	philippines	Philippines
pn	pitcairn-island	Pitcairn Island
PL	poland	Poland
PT	portugal	Portugal
QA	qatar	Qatar
RE	reunion	Réunion
RO	romania	Romania
RU	russia	Russia
RW	rwanda	Rwanda
None	saint-barthelemy	Saint-Barthélemy
WS	samoa	Samoa
SM	san-marino	San Marino
ST	sao-tome-and-principe	São Tomé and Principe
SA	saudi-arabia	Saudi Arabia
SN	senegal	Senegal
RS	serbia	Serbia
SC	seychelles	Seychelles
SL	sierra-leone	Sierra Leone
SG	singapore	Singapore
SK	slovakia	Slovakia
SI	slovenia	Slovenia
SB	solomon-islands	Solomon Islands
SO	somalia	Somalia
ZA	south-africa	South Africa
GS	south-georgia-and-south-sandwich-islands	South Georgia and the South Sandwich Islands
KR	south-korea	South Korea
SS	south-sudan	South Sudan
ES	spain	Spain
LK	sri-lanka	Sri Lanka
sh	st-helena-ascension-and-tristan-da-cunha	St Helena, Ascension and Tristan da Cunha
KN	st-kitts-and-nevis	St Kitts and Nevis
lc	st-lucia	St Lucia
MF	st-maarten	St Maarten
None	st-martin	St Martin
PM	st-pierre-and-miquelon	St Pierre & Miquelon
VC	st-vincent-and-the-grenadines	St Vincent and The Grenadines
SD	sudan	Sudan
SR	suriname	Suriname
SZ	swaziland	Swaziland
SE	sweden	Sweden
CH	switzerland	Switzerland
SY	syria	Syria
TW	taiwan	Taiwan
TJ	tajikistan	Tajikistan
TZ	tanzania	Tanzania
TH	thailand	Thailand
PS	the-occupied-palestinian-territories	The Occupied Palestinian Territories
None	the-uk-permanent-delegation-to-the-oecd-organisation-for-economic-co-operation-and-development	The UK Permanent Delegation to the OECD (Organisation for Economic Co-operation and Development)
TL	timor-leste	Timor Leste
TG	togo	Togo
TO	tonga	Tonga
TT	trinidad-and-tobago	Trinidad and Tobago
TN	tunisia	Tunisia
TR	turkey	Turkey
TM	turkmenistan	Turkmenistan
TC	turks-and-caicos-islands	Turks and Caicos Islands
TV	tuvalu	Tuvalu
UG	uganda	Uganda
None	uk-and-the-commonwealth	UK and the Commonwealth
None	uk-delegation-to-council-of-europe	UK Delegation to Council of Europe
None	uk-delegation-to-organization-for-security-and-co-operation-in-europe	UK Delegation to Organization for Security and Co-operation in Europe
None	uk-joint-delegation-to-nato	UK Joint Delegation to NATO
None	uk-mission-to-the-un-geneva	UK Mission to the UN Geneva
None	uk-mission-to-the-united-nations	UK Mission to the United Nations
None	uk-mission-to-the-united-nations-new-york	UK Mission to the United Nations, New York
None	uk-representation-to-the-eu	UK Representation to the EU
UA	ukraine	Ukraine
AE	united-arab-emirates	United Arab Emirates
GB	united-kingdom	United Kingdom
UY	uruguay	Uruguay
US	usa	USA
UZ	uzbekistan	Uzbekistan
VU	vanuatu	Vanuatu
VE	venezuela	Venezuela
VN	vietnam	Vietnam
WF	wallis-and-futuna	Wallis and Futuna
EH	western-sahara	Western Sahara
YE	yemen	Yemen
ZM	zambia	Zambia
ZW	zimbabwe	Zimbabwe
